com.bfs.ninjump	4.5
com.bfs.papertoss	4.4
com.backflipstudios.android.ninjumpdeluxe	4.5
com.backflipstudios.android.aodd	4.6
com.ggnes.supermario2	None
com.tatem.dinhunter	4.4
org.cocos2dx.POPClassic	None
com.kiloo.frisbeeforever	4.4
eu.aagames.dragopet	4.2
com.tls.jewelsfree	4.1
com.aidigame.xcity	4.7
com.papaya.papayafarm2011	None
com.glosculptor.glowpuzzle	4.5
com.backflipstudios.android.graffitiball	4.5
com.backflipstudios.android.strikeknight	4.2
com.papaya.papayaFish_hd	4.1
com.backflipstudios.android.solitaire	4.3
com.mando.babelrising3d	4.3
com.alten.mybrute	4.5
com.eekgames.worddrop	4.3
com.dbsaidem.soccerfree	4.2
com.papaya.papayaandroidfarm	4.3
com.mindstormstudios.android.whacksytaxi	3.8
com.papaya.treasure	4.1
com.fluik.OfficeJerkFree	4.2
com.snsgame.petin.android	4.0
eu.mvns.games.blackjack	4.7
com.strikermanager.android.strikersoccer	4.2
com.tls.harborcaptainfree	None
com.tls.crosswordsearchfree	4.3
com.hyperkani.airhockey	4.1
com.backflipstudios.android.shapeshift	4.0
com.papaya.papayapetparadise_beta	None
com.papaya.papayaandroidmotofarm_hd	None
com.dreamfabpapaya.savingyello	4.3
com.dunliu	4.1
com.tls.dessertdash	4.2
com.bbb.btr	4.1
com.lolstudio.fever.cafe	None
com.papaya.papaya.farm	None
com.aidigame.dinoparadisepapaya	4.7
com.bfg.mtt	4.8
com.MindstormStudios.MafiaFarm	4.4
com.andoop.run3d	4.3
com.loloworks.llzbs	4.9
com.RenownEntertainment.BallHop	4.3
com.wey.smallbird	3.8
com.candyboxstudio.ava	None
com.celliecraze.mm	None
com.hyperkani.hyppely	4.2
com.MindstormStudios.KingdomOfHeroes	4.4
com.ama.crossfingers.ppy.free	3.6
com.twoclams.hww.android.live	4.4
com.lol.fever.fashion	4.1
com.papaya.papayaLepadFish	None
com.candyboxstudio.twistedcircus	3.9
com.papaya.miracle1	4.4
com.mobgame.hunter.ppy	4.8
com.papaya.starempire	4.0
com.virtuesoft.superboxfree	3.5
com.jkb.wordplayfree	4.4
com.diedgamers.wsr	4.1
com.papaya.play	3.2
com.cordof.snake	4.4
com.begamer.android.ninja	3.9
com.wanmei.ruiling.tuijinbi	3.8
com.saturdaysoft.game.fishingvida	4.2
com.papaya.papayafarm2012	4.0
com.papaya.androiddiamond	None
com.techone.brapaypal	None
com.papaya.papayapremium2	None
cn.hakuna.papaya.ppq	3.6
com.wiselinc.miniTown.main.papaya	3.5
com.apostek.apps.pokiemonster	4.1
com.ggnes.contra	None
com.easygame.weaponchicken	4.6
hu.javaforum.android.falldown	4.1
com.ggnes.princeofpersia	None
cn.bluesky.fourinaline	3.8
com.ama.puzzle_f2p	4.2
org.cocos2d	None
sunny_day.CatvsDogLite	None
com.xenoegg.doodle	None
eggball.amoon.papaya	3.8
neves.project.taiwanmahjongdemo	3.8
com.papaya.papayafarm2012_digisy	4.2
com.techone.iworshipnoad	None
com.free.snes.DonkeyKongCountry3	None
com_buck_cagematch.com_buck_cagematch_Cage_Match	4.3
com.papaya.pieen	4.2
com.tatem.robosockets	4.0
appinventor.ai_Broak.PaintballWiz	3.7
com.papaya.zombieWars	4.1
com.thesocialsoft.Nyan	None
com.freead.nesgame.superMarioBros3	None
org.dk.ubj	4.3
com.techone.pipe	None
com.car.mania.racing	4.5
jp.co.sega.FallenRealms	4.3
cn.bluesky.neatreversi	3.8
com.papaya.papayaandroidmotopet	None
mobi.memnemonic	3.6
com.papaya.androidbobble	None
sunnyday.findball	4.2
com.glosculptor.blocks	3.7
com.mobean.bacwar	4.0
com.CasualGameStore.FairyCubesFree	4.0
com.techone.balls	None
com.papaya.papayaandroidPoker	3.6
com.threeloops.android.memesmasher	None
com.stormjoy.forestfair	4.4
com.orpine.puzzle	5.0
com.papaya.papayaandroidpark	3.4
sunny_day.kids_sunny_math	1.0
com.papaya.papayaFruit	None
com.papaya.papayaMardigras	None
com.m3java.cloudbird	4.2
com.armoredsoft.android.armoreddefense.gamelite	4.2
social.sample	None
com.celliecraze.wordsearch.view	None
com.ggnes.donkeykong	None
com.f5tbl.trailhitPapaya	None
com.papaya.androidchess	None
com.papaya.miracle2	None
com.free4android.android.goldpapaya	None
com.techone.DuiDuiPeng	None
com.adamschmelzle.origami.daisy	3.8
com.ggnes.battlecity	None
com.cis.idp	4.2
com.haypi.kingdom.papaya	4.4
com.thesocialsoft.Collapse	4.6
com_joyclouds.com_joyclouds_Running_Panda	None
com.redkatana.brewmasters3d	2.6
ns.feedmeworms	5.0
com.alchemylords	None
com.techone.hamster	None
com.twoclams.hww.android	3.9
org.mt.android.game.superdj	3.7
sunny_day.sunny_math_lite	4.2
com.kuwan.game.railroad.kingdom	4.3
sea_android	None
com.blogspot.androidresearch.galaxystrike	3.8
wdc.project.digitalataxx2	None
com.aidigame.dinoparadisepapaya_beta	4.5
com.papaya.androidlinlink	None
com.gaidde.okho	None
com.upon.herofight.papaya	4.6
com.ggnes.punchout	None
com.adamschmelzle.abp	3.8
com.dnadevstudios.legacypaid	3.3
com.papaya.papayaSLinlink_hd	3.8
pipo.android	None
com.celliecraze.rotateroll	None
com.kaenaacorp.hungryyogifree	None
com.nachoapps.diezombiedie	4.4
com.gamesbrewer.guppylabs	None
com.samsoft.balance	4.2
com.freead.nesgame.marioBros	None
com.freead.nesgame.emu	None
com.ggnes.digdug	None
com.papaya.papayafarm2012iab	None
com.myumyu.molevillagechampions	2.8
com.tvf.hoboVSantsSkeleton	4.4
com.xenoegg.impact	None
com.papaya.papayaBobble_hd	3.5
com.ggnes.adventureicemario	None
com.goosyAvatar	2.9
com.adamschmelzle.origami.rose	4.2
com.MindstormStudios.KingdomOfHeroesBeta	4.4
org.dk.banluck	4.5
de.goddchen.android.colorattentiontest	None
org.ssg.android.game.herogame	None
com.techone.minihamster	None
com.barcodecity	None
com.smallhurricane.dg	4.5
com.adamschmelzle.origami.sunflower	4.1
com.adamschmelzle.origami.orchid	4.0
com.papaya.androidblackjack	None
com.icewings.word.wordchallenge	None
com.freead.nesgame.superContact1	None
com.dreamheartgames.dreamlife	4.0
com.afmobi.uncartedocean	None
com.freead.nesgame.bomberMan	None
com.dereklam0528.birdEscape	4.5
com.ggnes.popeye	None
com.adamschmelzle.origami.iris	4.4
com.papaya.miracle_beta	None
de.goddchen.android.memory	None
com.armoredsoft.android.armoreddefense.game	4.3
com.gamepro.neoncatch	5.0
com.haypi.kingdom.papaya.activity	None
de.goddchen.android.shakedroid	None
com.celliecraze.marblemadnesseditor	None
com.freead.nesgame.exciteBike	None
com.gamepro.neoncatch2	None
com.zihwan.iting	None
com.apphu.crouchingpanda	None
com.geminoid	None
com.myumyu.moletribe	5.0
com.metoogames.island	None
com.papaya.androidfive	None
com.elex.quefly.animalnations.papaya.global	4.4
com.free.snes.SonictheHedgehog	None
com.papaya.pandaen	3.9
de.goddchen.android.dailyquestion	None
com.komastudios.iwastedisposer	5.0
com.hooplahoo.game.zoox	None
com.ggnes.doubledragon3	None
com.adamschmelzle.abppaid	None
com.freead.nesgame.SuperMarioBros3M	None
com.ggnes.adventureislandspanish	None
com.ggnes.legendofzelda	None
com.ggnes.megaman3	None
com.papaya.androidothello	None
com.papaya.simfish	None
ru.funapp.games.videopoker	4.1
com.techone.sexmatch	None
net.droidstick.finger.cn	None
org.drhu.iRadio	2.8
Ta'adol	None
com.freead.nesgame.chipAndDale2	None
1st	None
com.free.snes.UnchartedWaters	None
com.ggnes.doubledragon2	None
com.freead.nesgame.onein1	None
com.glosculptor.blocks.crystal	None
com.alawar.DrunkVikings	None
com.ggnes.8eyes	None
com.freead.nesgame.SuperMarioBrosNight	None
com.papaya.cave	None
com.free.snes.zelda	None
net.july.myGame	3.4
com.wangwei.eat.apple	None
com.papaya.papayaGameHub	None
pipo.droid.tapbasic	None
com.papaya.social.demo.iab.test10086	5.0
com.wimolife.VideoTube	3.4
en.hakuna.SuperGold.deprecated	None
CrazySliper.apk	None
com.tigersunrise.pixelpanions	None
com.timeplusq.princeofdroidia	5.0
wdc.project.digitalflipflip	None
com.ggnes.adventurekingdom	None
com.freead.nesgame.MarioYoshi	None
com.ggnes.dragonquest2	None
com.awokerGames.scrt	4.5
com.ggnes.3dbattleworldrunner	None
com.creature.papaya.actividades	None
com.ggnes.donkeykong3	None
com.free.snes.Battletoads	None
com.ggnes.tenyardfight	None
com.free.snes.CrazyMarioWorld	None
com.orpine.en.threepigs	5.0
com.free.snes.DonkeyKong	None
com.ggnes.adventurebayoubilly	None
com.free.snes.DonkeyKongCountry2	None
com.ggnes.adventurelolo	None
com.free.snes.DragonBallZLa	None
com.ggnes.doubledragon	None
com.free.snes.FinalFantasyV	None
com.ggnes.dragonquest3	None
com.free.snes.HarvestMoon	None
com.herocraft.game.papaya.yumsters	None
com.free.snes2.KingofDragons	None
com.freead.nesgame.StreetFighter2	None
